Afghanistan | Kabul | Asia
Albania | Tirana | Europe
Algeria | Algiers | Africa
Andorra | Andorra la Vella | Europe
Angola | Luanda | Africa
Argentina | Buenos Aires | America
Armenia | Yerevan | Europe
Australia | Canberra | Oceania
Austria | Vienna | Europe
Azerbaijan | Baku | Europe
Bahamas | Nassau | America
Bahrain | Manama | Asia
Bangladesh | Dhaka | Asia
Barbados | Bridgetown | America
Belarus | Minsk | Europe
Belgium | Brussels | Europe
Belize | Belmopan | America
Bhutan | Thimphu | Asia
Bolivia | La Paz | America
Bosnia and Herzegovina | Sarajevo | Europe
Botswana | Gaborone | Africa
Brazil | Brasilia | America
Brunei | Bandar Seri Begawan | Asia
Bulgaria | Sofia | Europe
Burkina Faso | Ouagadougou | Africa
Burundi | Bujumbura | Africa
Cabo Verde | Praia | Africa
Cambodia | Phnom Penh | Asia
Cameroon | Yaounde | Africa
Canada | Ottawa | America
Central African Republic | Bangui | Africa
Chile | Santiago | America
China | Beijing | Asia
Colombia | Bogota | America
Comoros | Moroni | Africa
Democratic Republic of the Congo | Kinshasa | Africa
Republic of the Congo | Brazzaville | Africa
Costa Rica | San Jose | America
Croatia | Zagreb | Europe
Cuba | Havana | America
Cyprus | Nicosia | Europe
Czech Republic | Prague | Europe
Denmark | Copenhagen | Europe
Dominica | Roseau | America
Dominican Republic | Santo Domingo | America
Ecuador | Quito | America
Egypt | Cairo | Africa
El Salvador | San Salvador | America
Equatorial Guinea | Malabo | Africa
Eritrea | Asmara | Africa
Estonia | Tallinn | Europe
Ethiopia | Addis Ababa | Africa
Fiji | Suva | Oceania
Finland | Helsinki | Europe
France | Paris | Europe
Gabon | Libreville | Africa
Gambia | Banjul | Africa
Georgia | Tbilisi | Europe
Germany | Berlin | Europe
Ghana | Accra | Africa
Greece | Athens | Europe
Guatemala | Guatemala City | America
Guinea | Conakry | Africa
Guinea-Bissau | Bissau | Africa
Guyana | Georgetown | America
Honduras | Tegucigalpa | America
Hungary | Budapest | Europe
Iceland | Reykjavik | Europe
India | New Delhi | Asia
Indonesia | Jakarta | Asia
Iran | Tehran | Asia
Iraq | Baghdad | Asia
Ireland | Dublin | Europe
Israel | Jerusalem | Asia
Italy | Rome | Europe
Jamaica | Kingston | America
Japan | Tokyo | Asia
Jordan | Amman | Asia
Kazakhstan | Astana | Asia
Kenya | Nairobi | Africa
Kiribati | South Tarawa | Oceania
Kosovo | Pristina | Europe
Kuwait | Kuwait City | Asia
Kyrgyzstan | Bishkek | Asia
Laos | Vientiane | Asia
Latvia | Riga | Europe
Lebanon | Beirut | Asia
Lesotho | Maseru | Africa
Liberia | Monrovia | Africa
Libya | Tripoli | Africa
Liechtenstein | Vaduz | Europe
Lithuania | Vilnius | Europe
Luxembourg | Luxembourg | Europe
Macedonia | Skopje | Europe
Madagascar | Antananarivo | Africa
Malawi | Lilongwe | Africa
Malaysia | Kuala Lumpur | Asia
Maldives | Male | Asia
Mali | Bamako | Africa
Malta | Valletta | Europe
Marshall Islands | Majuro | Oceania
Mauritania | Nouakchott | Africa
Mauritius | Port Louis | Africa
Mexico | Mexico City | America
Micronesia | Palikir | Oceania
Moldova | Chisinau | Europe
Monaco | Monaco | Europe
Mongolia | Ulaanbaatar | Asia
Montenegro | Podgorica | Europe
Morocco | Rabat | Africa
Mozambique | Maputo | Africa
Namibia | Windhoek | Africa
Nauru | Yaren District | Oceania
Nepal | Kathmandu | Asia
Netherlands | Amsterdam | Europe
New Zealand | Wellington | Oceania
Nicaragua | Managua | America
Niger | Niamey | Africa
Nigeria | Abuja | Africa
North Korea | Pyongyang | Asia
Norway | Oslo | Europe
Oman | Muscat | Asia
Pakistan | Islamabad | Asia
Palau | Ngerulmud | Oceania
Palestine | Ramallah | Asia
Panama | Panama City | America
Papua New Guinea | Port Moresby | Oceania
Paraguay | Asunci√≥n | America
Peru | Lima | America
Philippines | Manila | Asia
Poland | Warsaw | Europe
Portugal | Lisbon | Europe
Qatar | Doha | Asia
Romania | Bucharest | Europe
Russia | Moscow | Asia
Rwanda | Kigali | Africa
Saint Kitts and Nevis | Basseterre | America
Saint Lucia | Castries | America
Saint Vincent and the Grenadines | Kingstown | America
Samoa | Apia | Oceania
San Marino | San Marino | Europe
Saudi Arabia | Riyadh | Asia
Senegal | Dakar | Africa
Serbia | Belgrade | Europe
Seychelles | Victoria | Africa
Sierra Leone | Freetown | Africa
Singapore | Singapore | Asia
Slovakia | Bratislava | Europe
Slovenia | Ljubljana | Europe
Solomon Islands | Honiara | Oceania
Somalia | Mogadishu | Africa
South Africa | Pretoria | Africa
South Korea | Seoul | Asia
South Sudan | Juba | Africa
Spain | Madrid | Europe
Sudan | Khartoum | Africa
Suriname | Paramaribo | America
Swaziland | Mbabane | Africa
Sweden | Stockholm | Europe
Switzerland | Bern | Europe
Syria | Damascus | Asia
Taiwan | Taipei | Asia
Tajikistan | Dushanbe | Asia
Tanzania | Dodoma | Africa
Thailand | Bangkok | Asia
Togo | Lome | Africa
Trinidad and Tobago | Port of Spain | America
Tunisia | Tunis | Africa
Turkey | Ankara | Asia
Turkmenistan | Ashgabat | Asia
Tuvalu | Funafuti | Oceania
Uganda | Kampala | Africa
Ukraine | Kyiv | Europe
United Arab Emirates | Abu Dhabi | Asia
United Kingdom | London | Europe
United States of America | Washington | America
Uruguay | Montevideo | America
Uzbekistan | Tashkent | Asia
Vanuatu | Port Vila | Oceania
Venezuela | Caracas | America
Vietnam | Hanoi | Asia
Zambia | Lusaka | Africa
Zimbabwe | Harare | Africa
